Splash!
Don't let the penguins fall into the water!
1
3 1 left
#.......#
#...r...#
#.......#
#.     .#
#.     .#
#.     .#
#.......#
#...r...#
#.......#